11111111111111111
10000P00000001C01
10000000000001011
10011110000000001
10000E10000000C01
11111111111111111
