111111111111111111111111111
1P0000000000C000000000000E1
101011111101111110111000101
1C00000000000000000000111C1
111011000001111101110000001
111111111111111111111111111