11111111111111111111111
100N0CCCE10001000000101
1P001001111000000100001
10000000010001000000001
10000000000000001000001
10000100000001000001001
11111111111111111111111